character	description
Lizard Baraka	Lizard Baraka doesn't react to opponent's Basic Combo attacks for 15 seconds after tag-in. In a fight, he passively generates power over time and receives 2% Damage boost each time he hits the opponent with an additional 1% Damage boost if the hit was critical. On tag-out Lizard Baraka loses Damage boost and gains Regeneration for 10 seconds. Active opponent's healing is reduced by 25% for each Lizard character in a team. Outworld teammates have 25% Critical hit Chance Boost.
Scourge Baraka	For each Outworld character on his team, Baraka performs an additional Combo Ender attack which applies a bleed DOT with increased duration. Baraka's bleed DOTs can stack.
Dragon Breath Bo' Rai Cho	Combo enders and critical hits have a 50% Chance to inflict additional damage on one of the tagged-out opponents. +25% critical hit chance for all Martial Artists.
Covert Ops Cassie Cage	All Spec Ops teammates have a 25% chance of unblockable attacks.
Kombat Cup Cassie Cage	On tag-in, Kombat Cup Cassie Cage brands an active opponent as an Outsider for 20 sec. Any attack against the Outsider is unblockable with 50% chance. When an Outsider tries to tag-out, Cassie's drone deals 30% damage to their current health. The drone doesn't deal damage to Bosses. All Kombat Cup Characters on the team are immune to Cripple.
Standard Cassie Cage	+50% health if teamed with Johnny Cage, +50% attack if teamed with Sonya Blade.
Strike Force Cassie Cage	Each time Cassie tags-in, she drains 1 bar of power from the enemy team, as well as slowing the current opponent for 4-16 seconds. Strike Force teammates receive +15-25% more health and attack. On tag-in, Strike Force teammates are immune to lethal and critical hits for 5-7 seconds.
Undercover Cassie Cage	+20% to all damage vs. Netherrealm and Outworld.
Standard D'Vorah	Spikes damage opponents who use basic attacks. Immune to poison and bleed.
Swarm Queen D'Vorah	D'Vorah's Vortex Swarm (Special Attack 2) can inflict multiple effects on the opponent. Immune to poison.
Venomous D'Vorah	D'Vorah's basic attacks do +100% damage per negative effect on the opponent. D'Vorah's Poison can stack 2 times.
Wretch D'Vorah	When D'Vorah defeats an opponent, she applies a low/medium/high damage, infinite poison DOT to the opposing team. Her teammates do +10-30% critical damage against enemies affected by poison.
Klassic Ermac	Opponents start the fight with Soul Siphon DOT, that takes 10% of their health and prevents recovery over 30 seconds (even if Ermac is tagged-out or defeated). Soul Siphon DOT is not affected by any modifiers or resistances. When Ermac is defeated (and is not the last one on his team) he explodes dealing massive damage to an active opponent.
Master of Souls Ermac	Starts with +1 bar of power for each Outworld teammate.
Pharaoh Ermac	For every Character that is defeated, and for each opponent that resurrects, your team takes less damage and gains increasing critical hit chance. These effects stack.
Spectral Ermac	When a teammate is defeated, gain 50% of their attack and toughness. Max once per match.
Standard Ermac	When a teammate is defeated, gain 40% of their attack and toughness. Max once per match.
Black Dragon Erron Black	Black Dragon Erron Black has a 30-50% chance to give covering fire to his teammate when he tags-out, and to support a teammate when an opponent tags-in. When tagged out, Black Dragon Erron Black provides cover fire for his Black Dragon teammates every 20-12 seconds. Cover fire has 35% chance to Stun. Achieving 90%+ on Special Attack 1 makes it unblockable. Black Dragon Erron Black can join any class.
Day of the Dead Erron Black	When using special attacks, Day of the Dead Erron Black has a 20-40% chance to get them for free and power drain the opponent. When this happens, 30% of the time he will power drain the whole opponent team. When defeated, Erron Black's ghost has a 20-50% chance to assist Day of the Dead characters on combo enders and special attacks.
Gunslinger Erron Black	+30% attack vs Spec Ops. Achieving 80%+ on Stand Off (Special Attack 2) makes it unblockable and a critical hit.
Nightmare Freddy Krueger	One of Freddy's opponents is trapped in a Nightmare. Freddy has a 30-50% chance for Lethal Blow to that opponent. If Freddy Krueger has 2 Nightmare teammates, he can trap an additional opponent in the Nightmare. Nightmare teammates gain +10% critical hit chance on basic attacks.
MK11 Frost	While MK11 Frost is active, she charges Time Freeze Impulse extra attack every 30 sec. Activation of the Impulse grants her 20% of her maximum health and power, and drastically slows the time around her for 6 seconds. Each hit on the opponent affected by the Impulse applies stacking Kinetic effect. When the time flow returns to normal, the opponent receives additional damage based on the amount of the Kinetic stacks. Special Attacks started while the Impulse is active apply Team Frostbite for 7 sec.
MK11 Fujin	Fujin has increased Combo Ender chance. Performing a Combo Ender triggers a chain of three challenges. Achieving 80% on the challenge inflicts the Hurricane effect on the enemy for 20 seconds. The first Hurricane increases all incoming damage to the enemy by 10/15/30%. The second slows the enemy down by 10/20/40%. The third Hurricane disables enemy's Special Attacks. If the opponent is already inflicted with Hurricane the chain of challenges will not start. Lightning hitting the Hurricane strikes the enemy three more times.
Onslaught Fujin	After 10 successful Basic Combo Attack hits, Fujin can choose to gain Tornado Ambush buff or an instant Random Bonus. If Basic Combo Attack is blocked, it counts as 0.5 hits for Air Wisdom. Tornado Ambush is active for 6 seconds, reduces the active opponent's attack by 10% (6% for bosses) and increases Fujin's attack by the same percentage for the rest of the fight. If a new opponent tags-in while Tornado Ambush is active, their attack will also be reduced. Maximum Fujin's attack boost and maximum attack reduction for each opponent - 50%. While tagged-out Fujin loses 5% of the increased attack amount every 5 seconds. Random bonuses: Instant Damage, Regain Health Instantly, Dispel, Drain 1 Bar of power Instantly, Gain 1 Bar of power Instantly
MK1 Geras	MK1 Geras can use his power to counter-attack the opponent and activate the Hourglass. While Geras is active, with their help he receives less damage, and also gradually heals himself and alive teammates, they receive 3% max Health for each 8-6% of his max power. Instead, Hourglass absorbs 50% of Geras and his current opponent power generation. When Geras tags-out, a Dust Storm begins, it slows down any opponent and is active for 7 sec. For every 25% of Health Geras has, his Basic attacks deal more damage, up to 60-100%. Cost of the Team Healing:  8-6%. Maximum Basic attack damage boost: 60-100%
Nightmare Ghostface	Ghostface alternates between Billy and Stu personalities, each offering unique combat bonuses. Billy gains a Ghostspirit every 2 Basic Attacks, boosting damage by 5% per stack (max 5 stacks). Stu switches in with a Shield active, removing Billy’s stacks and healing 7% of max health per removed stack. Each removed stack grants a 5% Power Generation boost. If Billy reaches 5 stacks of Ghostspirit, he becomes Manic for 13 seconds on Special Attack 2—granting 180% damage and disabling opponent tag-outs. While Manic, Billy ignores opponent attacks during combos and becomes unstoppable. Stu can only switch back once Billy calms down or after using Special Attack 2 or Fatal Blow.
Klassic Goro	Once per match, 10-8 seconds after Goro is defeated, Goro comes back into the fight with 25-50% health and with a devastating stomp. All characters on Goro's team do +10-20% attack.
Tigrar Fury Goro	Combo enders and special attacks have a chance of a fire DOT effect. All characters that do fire attacks on Goro's team have a 25% chance of causing fire DOT to enemy upon tagging-in.
American Treasure Homelander	Incoming damage reduced by 50%. At match start, one random opponent becomes the Archenemy and one random teammate becomes the Parental Figure. All opponents (except the Archenemy) deal 50% less damage to Homelander. Defeating opponents grants Dominance stacks; defeating the Archenemy gives 2 stacks. Each stack gives +25% attack. While both the Parental Figure and Homelander are alive and one of them is active, they gain Bonding effects over time. Each Bonding gives 1% Lethal chance boost for Special Attack 2, up to a maximum of 33 stacks. If Parental Figure with the maximum Bonding is defeated, Homelander wreaks blind revenge and deals extreme damage to the active opponent.
Cybernetic Jacqui Briggs	Takes 30% less damage vs. Netherrealm and Outworld.
High Tech Jacqui Briggs	All Spec Ops teammates have +20% increased power generation
Kosplay Jacqui Briggs	On tag-in Kosplay Jacqui Briggs mimicks one of the six Klassic Ninjas, each giving her a different unique combat effect and high bonuses against a certain Character type. Scorpion Kosplay: Special Attack 2 Team Fire, Combo Ender 1 Fire, Fire has increased Power Drain vs Spec Ops. Tremor Kosplay: Special Attack 2 Stun 30% Lethal Blow chance vs Netherrealm. Rain Kosplay: Special Attack 1 Dispel, 50% Basic Attack damage boost vs Outworld. Reptile Kosplay: Special Attack 2 Blind, Combo Ender 1 Poison, Poison Aura is active vs Martial Artists. Sub-Zero Kosplay: Special Attack 1 Frostbite, Combo Ender 1 Frostbite, 50% Critical Hit chance boost vs Outworld. Ermac Kosplay: Special Attack 2 Vampirism, Tag-in attack Vampirism, Damage reflection of blocked Special Attacks vs Netherrealm.
Standard Jacqui Briggs	The finishing blow of Jacqui's combo ender does +100% damage and stuns.
Assassin Jade	Assassin Characters on the team have 20-40% chance to dodge any special attack or combo ender. Jade retaliates with an unblockable, crippling attack that deals low/medium/high damage.
Day of the Dead Jade	After using Evocation (special attack 2) and after tagging-out, Day of the Dead Jade has a 20-40% chance to give all Day of the Dead Characters a Ghost Shield that reflects all damage at the enemy for 5-7 seconds.
Klassic Jade	Klassic Jade has 80% chance to apply Blind on any Special Attack. Every time an opponent misses an attack, Klassic Jade gains 10% Speed increase for 15 seconds, stacking up to 50%.
Lizard Jade	For every debuff that Lizard Jade or her teammates apply to the active opponent, her whole team gains the Team Thrill effect for 20 seconds (stack up to 5 times). Each of the Team Thrill effects buffs all of Lizard Jade's Basic and Special attacks to additionally deal 10% of its damage to all of the opponents. Lizard Jade's Combo Enders have 50% chance to apply Curse. With each Team Thrill effect, Lizard Jade's team intimidates the active opponent into their Power generation being reduced by 10%.
MK11 Jade	Jade has a 15-25% chance to dodge basic attacks, leaving the opponent slowed and open to counter attack for a brief time. MK11 teammates are healed by fire/bleed/poison.
Nightmare Jason Voorhees	Jason has 30-50% chance to evade all special attacks. After evading, Jason attacks and stuns his opponent. Nightmare teammates' special attack 2 have 20-30% chance of being unblockable.
Slasher Jason Voorhees	Even when defeated, Jason rises again with increased damage and +1 bar of power... twice.
Unstoppable Jason Voorhees	Even when defeated, Jason rises again with increased damage and +1 bar of power.
CoS Jax Briggs	After Jax or his opponent uses a special attack, there is s 30-50% chance Circle of Shadow Jax gains invulnerability for 2-4 seconds. Jax and his team gain +5-15% health for every Circle of Shadow Character on the team.
Farmer Jax Briggs	+30% recovery for Spec Ops teammates.
Heavy Weapons Jax Briggs	+30% toughness for all Spec Ops teammates. L.A.W. Blast (special attack 2) deals damage to the entire enemy team and breaks shields.
Klassic Jax Briggs	When blocking, there is 10-20% chance that all damage will be ignored from a Special Attack. Also, when blocking basic attacks, there is 10-20% chance to apply Weaken, Power Drain, or Cripple.
Onslaught Jax Briggs	Onslaught Jax can accumulate Heat effect while fighting. Jax gets 1 Heat stack for any attack received from an opponent, and for each performed successful Basic Attack he receives 2 Heat stacks. Jax gets 1% attack boost and 2% resistance to all negative effects per active Heat stack. Maximal amount of Heat stacks - 30. Successful Fatal Blow instantly charges Heat to maximum. When the Heat is fully accumulated, Jax can release it to instantly heal one of his team members, including himself, by 15% of their max Health. When the Heat is released, Jax applies Shield Break on his opponent.
Standard Jax Briggs	+15% toughness for Spec Ops teammates.
A-List Johnny Cage	+30% health for Spec Ops teammates.
Klassic Movie Johnny Cage	Along with all the other attacks, Klassic Movie Johnny Cage can perform special Combo Sequences. The Combo Sequences spend a bit of Power and must be performed by heart. "Caged Rage" - Pierce your enemy with a spear and make them Bleed: Swipe left → Tap → Swipe right. "Exiting the Dragon of Death" - Smash'n'Burn your foe: A Few Taps → Swipe left → Swipe right. "The Gist of my Fist" - Bring down an opponent with a hail of blows: Swipe right → A Few Taps.
Kombat Cup Johnny Cage	+15% to attack, health, toughness and recovery for all Kombat Cup characters on the team. When the opponent tries to tag-out, there is a 50% chance they get stunned by an incoming football instead.
Ninja Mime Johnny Cage	+30% recovery for Martial Artist teammates.
Standard Johnny Cage	+15% health for Spec Ops teammates.
Strike Force Johnny Cage	If an opponent resurrects, Johnny instantly gains 1 bar of power. Strike Force Johnny Cage gains up to +50-100% damage and +15-25% power generation as he loses health. All Strike Force teammates do +10-30% damage vs. Netherrealm characters.
Stunt Double Johnny Cage	Stunt double attacks on tag in, stunning the opponent.
Black Dragon Kabal	On Tag-in, Kabal stuns and curses the opponent. When reduced to below 50% health, Kabal gets 15-35% chance for unblockable attacks. When a Black Dragon teammate is defeated, Kabal will tag-in and if unblocked, will perform his Fatal Blow attack. Black Dragon teammate combo enders and special attacks count as sneak attacks (cannot be dodged).
Klassic Kabal	When Klassic Kabal tags-in, he stuns the opponent with his dash. He gains Venom on successful tag-in attack and Combo Enders. Each stack of Venom slightly increases speed, gives a 5% power generation boost, and a 3% chance to counter-attack the opponent’s basic attack. When Klassic Kabal collects 3 stacks of Venom, he can use them to gain Adrenaline for 10 sec. While Adrenaline is active, it gives Klassic Kabal a speed boost from the collected Venom, and a 30% unblockable Special Attack chance. Performing SPl mini-game at 80%+ will apply Poison to the opponent.in.
MK11 Kabal	When MK11 Kabal tags-in, he gains speed increase for 4-12 seconds and stuns the opponent with his dash. When an MK11 teammate is stunned, Kabal will attempt to stun the opponent and remove stun from his teammate. When an MK11 teammate is defeated, Kabal will tag-in and if unblocked, will perform his Fatal Blow attack.
Black Dragon Kano	Black Dragon Kano inflicts a 3-5 second cripple or weaken on combo enders. For each Black Dragon teammate, Kano gains 1 bar of power and +5-15% health at the start of the match.
Commando Kano	+25% critical hit chance. Immune to blind.
Klassic Kano	Any attack blocked by the opponent has a 25% chance of stunning the opponent. Kano has 100% critical hit chance against enemies affected by stun.
Standard Kano	+30% attack if the opponent has 40% or lower health.
Balanced Kenshi	All Spec Ops teammates start with one bar of power.
Elder God Kenshi	When opponents are defeated by Kenshi's special attacks, he and his teammates gain a bar of power. Elder God teammates are immune to critical attacks and have +20% critical hit chance on Basic Attacks.
MK1 Kenshi	After 3 successful Combo enders, Kenshi MK1 can summon the ancestors' spirit that unleashes a terrifying Spectral attack on the opponent. Performing mini-games at 80%+ activates the chain of attacks with progressively increasing speed, damage and critical attack chance. Kenshi applies Blind for 2 sec. for each Spectral attack performed. When Kenshi defeats an opponent, he applies Team Ancestors Damnation which power drains opponents and prevents from generating power for 5 sec.
Possessed Kenshi	Ambushes opponent on tag-in, setting victim on fire.
Ronin Kenshi	When Kenshi blocks a Special Attack, his attacks gain 100% unblockable and critical for 2-4 seconds. +30% attack for each Ronin teammate vs. Martial Artists.
Standard Kenshi	+40% attack when teamed with Martial Artists; +40% health when teamed with Spec Ops.
Shokan Warrior Kintaro	If Kintaro successfully blocks a special attack he has a Chance to retaliate with a jump stomp on the opponent which applies fire DOT. Kintaro and his Team have increased resistance to fire DOT.
Assassin Kitana	Ambushes opponent on tag-in with vicious stabs causing bleed for 5-15 seconds. Assassin Characters generate 10-30% more power. Assassin Kitana is immune to critical hits.
CoS Kitana	After defeating an opponent, Kitana enslaves the victim to fight for her, once per match. The enslaved Character does not have their passive ability or Equipment but has 20-50% of their health. Bosses are immune. If Kitana has 2 Circle of Shadow teammates, she can use her passive twice. Kitana gains 25% Lethal Blow chance against opponents affected by Weaken. Circle of Shadow Characters are immune to fear.
Day of the Dead Kitana	On enemy resurrection and when anyone is defeated, Kitana and Outworld teammates receive regen that recovers 20-40% of their health over 5-10 seconds. Day of the Dead Kitana is immune to bleed.
Edenian Blood Kitana	Edenian Blood Kitana can use her Power to create a defensive Whirlwind around herself. Edenian Blood Kitana spends 33% of Bar of Power per second to keep the Whirlwind active, reducing incoming damage by 70% and reflecting all debuffs to her opponent. If she manages to maintain the Whirlwind for 3 seconds or more, instead of disappearing it will transfer to the opponent and explode after 3 seconds, dealing high damage and applying Stun to the opponent. The explosion can be avoided by tagging-out before the explosion countdown ends. While Whirlwind is active, Edenian Blood Kitana's tagged-out Outworld teammates generate additional 2% of Max Power per second.
Klassic Kitana	+30% recovery for Outworld teammates.
MK2 Movie Kitana	Kitana drains 1 Bar of power from her active opponent every 12 sec. When this effect triggers, it charges Piercing Fans extra attack with Weak Points minigame. All Kitana's Power Drain also affect tagged-out foes, draining them for an additional 20% from the power of the effect. Piercing Fans: During this attack, three Weak Points on the opponent should be targeted in the correct order of their appearance. Kitana throws one Fan for each successfully targeted Point. Each fan hit applies Pierced effect for 3 seconds. It removes active and prevents gaining new buffs. Affected opponents can't tag out and Kitana has a 100% Crit chance boost against them.
Mournful Kitana	All Outworld teammates start with +1 bar of power.
Ronin Kitana	+30% attack for each Ronin teammate vs. Outworld. All Ronin characters gain 10-20% critical hit chance for each Ronin character on team.
Blood God Kotal Kahn	Kotal Kahn summons a Totem on his Special Attack 2, choosing between damage boost, healing, or power generation boost.
Dark Lord Kotal Kahn	Dark Lord Kotal Kahn summons an Osh-Tekk warrior to fight in his place after using his Sword Quake (special attack 2). Maximum 2 warriors per battle.
Standard Kotal Kahn	+15% attack for Outworld teammates.
Sun God Kotal Kahn	+30% attack for Outworld teammates.
Bojutsu Kung Jin	Kung Jin gains power when blocking attacks.
Marksman Kung Jin	Kung Jin's finishing arrow from his combo ender inflicts unique effects: Life drain, stun, or fire.
Shaolin Kung Jin	All Martial Artists teammates start with 1 bar of power.
Standard Kung Jin	+30% critical hit chance for all Martial Artist teammates.
CoS Kung Lao	When using special attacks Circle of Shadow Kung Lao has a 20-40% chance to get it free. All Circle of Shadow teammates start combat with +0.5-1.5 bar of power.
Hat Trick Kung Lao	All Martial Artist teammates deal +50% critical damage. Kung Lao has +25% critical hit chance.
Shaolin Fist Kung Lao	While Kung Lao is tagged-in, all Martial Artists on his team get +50% power generation. If Kung Lao defeats an opponent, this bonus is increased to +100%.
Shaolin Master Kung Lao	All Bronze teammates receive +300% attack, health, toughness, and recovery.
Nightmare Leatherface	After performing or being attacked with a combo ender, Leatherface has a 30% chance to become enraged: 200-300% damage boost for 4-6 seconds. Whenever a teammate stuns an opponent, there is a 30-50% chance Leatherface will come running from behind to attack.
Lin Kuei	+5% health for Martial Artist teammates
CoS Liu Kang	When Liu Kang starts a match, he has 100% critical hit chance and his opponent is stunned for 3-5 seconds. In Faction Wars, 25-35% chance for Lethal Blow. Lethal Blows heal all Circle of Shadow teammates for 5-15% of the damage dealt.
Fire God Liu Kang	Each time Fire God Liu Kang is affected by Fire DOT or he applies Fire DOT to an enemy, Liu Kang slightly heals and gains 1 Dragon Fire, permanently increasing his total Health by 5%. Additionally, the more Dragon Fire acquired, the more powerful Fire God Liu Kang becomes: 1 Dragon Fire - Bicycle Kick (SP1) applies Fire DOT. 2 DFs - 50% Basic damage boost. 3 DFs - Achieving 80%+ on Bicycle Kick (SP1) extends the attack, dealing more damage. 4 DFs - Flying Dragon Kick (SP2) also applies Shield Break. 5 DFs - Achieving 90%+ on Bicycle Kick (SP1) extends the attack a second time, dealing even more damage.7 DFs - 200% Basic damage boost
Flaming Fists Liu Kang	On tag in, Liu Kang receives a Speed increase, +100% basic attack damage, and +25% critical hit chance for 5 seconds.
Klassic Liu Kang	Liu Kang heals when affected by Fire, and is immune to Bleed, Poison, and Power Drain effects. Incoming DOTs instead grant Liu Kang 30-50% Critical Hit chance boost, and Power Drain grants 30-50% basic attack damage boost. Liu Kang and teammates apply Cripple on tag-in.
MK11 Liu Kang	MK11 Liu Kang has a 35% unblockable chance on Special Attacks. With each successful hit Liu Kang applies a Concussion effect to his opponent, which stacks up to 20-50 times. Each Concussion increases Critical Hit chance and Unblockable Attack chance against the opponent by 1%. Liu Kang counterattacks the opponent's Special Attacks with a chance equal to the number of Concussion effects on the opponent. For 15 seconds after tag-in, MK11 characters in Liu Kang's team are immune to Blind and their attacks cannot be dodged.
Klassic Mileena	When Mileena KO's an opponent, she recovers a percentage of that enemy's max health. Female teammates gain health when Mileena KO's an opponent.
MK1 Mileena	MK1 Mileena's Combo Enders apply Disease which decreases the opponent's maximum health by 4% (1% for bosses) and stacks up to 5 times. For each Disease on the opponent, Mileena's Lethal Blow Chance increases by 2% (1% for bosses). On the 5th stack, Poison applies on the opponent for 10 sec. and their unblockable attack chance decreases by 20%. MK1 Mileena can transform into Tarkat form by spending 1/0.9/0.8 power bars and gain Tarkat Hunger for 7/8/9 sec. During it Mileena vampirizes 40% of Basic Attacks damage, her X-Ray disables, and opponent can't tag-out. When Tarkat Hunger ends, Mileena transforms back and applies Primal Fear to the opponent for 3 sec. While this debuff is active, the opponent injures themselves and loses power over time.
Piercing Mileena	Attacks on bleeding enemy heal Mileena for 25% of damage dealt. Any bleed on Mileena grants her +1 bar of power.
Ravenous Mileena	A Tarkatan warrior attacks before Mileena tags-in, causing bleed with a 80-100% chance to stun. Also, everyone on her team deals +80-100% more damage on all fire/poison/bleed DOTs.
Vampiress Mileena	Any opponent fighting against Mileena for 10 seconds starts to bleed. Mileena gets regen on her Early Lunch (special attack 2), if opponent is suffering from bleed. All Netherrealm Characters gain +50% damage boost against enemies affected by bleed.
Monk	Upon death, each of his teammates receive 1 bar of power.
CoS Nightwolf	Circle of Shadow Nightwolf can impale an opponent throwing his Spirit Tomahawk, that remains in their body. Impaled opponent cannot restore their health. Summoning the Tomahawk back interrupts opponent's Basic Attacks and applies Slow for 10 seconds. Upon retrieval, Nightwolf instantly restores 1-3% of his max Health for each second the opponent has been impaled with the Tomahawk. Maximum 10-30%. If the opponent impaled with the Tomahawk tries to tag out, Nightwolf interrupts them, summoning the Tomahawk back. Nightwolf assists Circle of Shadow teammates with a Tomahawk throw upon their Block Breaker Basic Attacks, dealing damage and applying Shield Break for 5 seconds. Can trigger once per 5 seconds. He also assists his teammates upon opponent's tag-in, draining 1 bar of foe's power and dealing damage with a Tomahawk throw.
Klassic Nightwolf	Basic Attacks add Might, granting Klassic Nightwolf a 7% Basic Attack damage boost and increasing power generation by 2%. Might last 2 seconds and stacks up to 12 times. If Nightwolf is hit, then 1 stack of Might is removed. At 10 stacks or more, Nightwolf can use all Might to apply Spirit Wrath to the opponent for 12sec. While under Spirit Wrath, opponent has their debuff resistance or reflect ignored, and is additionally struck by lightning during Nightworlf's Special Attacks.
MK11 Nightwolf	When MK11 Nightwolf enters the fight, he calls to one of the spirit animals. Each spirit endues Nightwolf with power in the battle. Kiba the Wolf - Special Attack 1 applies Shield Break. Nightwolf gets 20% Basic damage boost stack every time he successfully performs any Special Attack. Komo the Bear - Special Attack 1 applies Cripple. Nightwolf has 20% chance to reflect Basic Attack and Special Attack 1 damage back to an opponent. Hana the Eagle - Special Attack 1 applies Power Drain. The Power Nightwolf's active opponent is gaining in the battle is reduced by 30%.
Darkest Knight Noob Saibot	On tag-in and on sucessful Fatal Blow, Darkest Knight Noob Saibot infects the current opponent with Madness, which lasts 9sec. Madness increases all incoming damage to the opponent, and reduces all damage dealt by the victim. Additionally, upon the first use of Special Attack 2 at the start of the match and after each tag-in, Noob can choose its combat effect from Cripple, Slow or Shield. If the opponent is knocked out or won't tag out before Madness ends, Noob creates a Minion Clone of them and can swap with it via the Puppet Master ability. Swapping with the Minion cannot be prevented, but the Minion can swap only with Noob. The Minion has a 50% unblockable attack chance and a 25% that any opponent's attack against him will miss.
Klassic Noob Saibot	Noob Saibot's Ghost Ball (Special Attack 1) disables his opponent's block, making all incoming attacks considered Unblockable for 10 seconds. When Special Attack 2 is performed at 80%+, it activates a continuous chain of Special Attacks, up to 6 times.
Lizard Noob Saibot	Lizard Noob Saibot gains energy from shadow each time he spends or loses his power. When his shadow energy bar completes, the Shadow Attack is available. This attack lets him choose any opponent as target and apply inevitable Snare. If the chosen opponent is tagged out, Noob will force them to stay in the fight through the portal. Upon defeating an opponent, Lizard Noob Saibot can resurrect a chosen teammate with 20% max health points. The number of times they revive is limited by the number of Lizard teammates.
MK11 Noob Saibot	MK11 Noob Saibot's Special Attacks apply Death Mark to his opponent, disabling all forms of resurrection and increasing future damage done by 10% for 20 seconds, stacking up to 3 times. After performing successful Special Attack 2, MK11 Noob Saibot summons his Shadow to fight in his place. Shadow starts with 15-25% of Noob Saibot's current Health. Max 3 Shadows per battle. When MK11 characters block an enemy Special Attack, Noob Saibot's Shadow counter-attacks and applies Death Mark.
Oni	When defeated, the opponent loses 1 bar of power.
Osh-Tekk	+5% attack for Outworld teammates.
CoS Quan Chi	Quan Chi can reflect damage from first three special attacks back at the opponent. Quan Chi's basic attacks have 10-30% chance to be unblockable. On tag-in, Circle of Shadow team members are granted vampirism on unblocked attacks for 10-20 seconds.
Warlock Quan Chi	Reanimates a dead teammate with 25% health. Max once per fight.
Dark Raiden	Bleed, fire and poison will heal Dark Raiden instead of damaging him. Power drain gives power instead of draining it.
Injustice 2 Raiden	Raiden's combo ender and special attacks do 10-20% damage to tagged-out opponents. While Raiden is active he lightly/moderately/heavily siphons opponent's power. Teammate's special attacks have a chance to Stun.
Klassic Raiden	Each time Raiden tags in, lightning strikes the active opponent, removing 20-40% of their current health and 20-66% of their power. Bosses are Immune. Raiden counts as Outworld and Martial Artist.
Klassic Movie Raiden	With a long tap on the screen with one finger, Raiden can accumulate Thunderstorm Energy to unleash crushing damage on the enemy, taking 4-10% of the boss's SP and 10-30% of the regular enemy's HP and applying Slow. During the energy accumulation, Raiden is especially vulnerable and any Basic or Special Attack can interrupt his concentration, deal increased damage and energy will need to be accumulated again. After performing Electric Rage (Special Attack 2), the enemy is enveloped in a lightning trap that prevents them from taking any action. The enemy can try to escape faster than the lightning will disperse on its own by beating the mini-game.
MK11 Raiden	30-50% Chance to stun the opponent on successful combo ender. When MK11 Raiden performs 3 combo enders, he disables the opponent's combo enders for the entire match.
Thunder God Raiden	When Raiden tags in, lightning strikes the opponent removing 20% of their current health.
Edenian Blood Rain	Edenian Blood Rain gains Tidal Might over time of every opponent affected by Soaked. Tidal Might empowers his Special Attacks and deals additional damage by lightning. Rain can use his extra attack Low Tide to apply Fear and Soaked for 20 seconds. He can also apply Soaked for 7 seconds on one of his Basic Combos. Low Tide has an 8-second cooldown.
Klassic Rain	Klassic Rain gains +15% Power generation increase till the end of the match per unique lasting negative effect applied by him or a teammate. Power Generation effect stack up to 7 times. Klassic Rain's Combo Ender have 20% chance to apply Soaked. Any negative effect applied to a Soaked enemy by a Klassic teammate has 35-75% chance to be applied as a Team negative effect.
MK11 Rain	MK11 Rain starts a match with one bar of Power. Rain has a 5-10% chance to immediately counter-attack an opponent's Basic Attacks. This counter-attack applies the Soaked debuff. Characters affected by Soaked are Slowed and take 10-35% more damage from Lightning Attacks. When an active enemy is affected by Soaked, each instance of Lightning attack will hit all enemies affected by Soaked (including those tagged out). Soaked lasts 10-20 sec.
Klassic Reptile	Whenever opponents tag-in, there is 60-80% chance they become poisoned (even when Reptile is tagged-out or defeated). All Outworld characters on Reptile's team have 60-80% critical hit chance against enemies affected by poison and have immunity to poison.
Kraken Reptile	When Reptile is hit by any attack, there is a chance acid blood splashes the enemy dealing unavoidable damage.
Nimble Reptile	+30% health for Outworld teammates.
Noxious Reptile	The entire team's bleed and poison damage are increased +30%.
Standard Reptile	+15% health for Outworld teammates.
Saurian	+5% health for Outworld teammates.
Hanzo Hasashi Scorpion	10% chance on basic attacks and 50% chance on combo enders to apply bleed. Hanzo Hasashi's bleed DOTs can stack. Martial Artists have a chance for -50% power cost for special attacks against enemies affected by bleed.
Hellspawn Scorpion	Martial Artists on Scorpion's team start the match with +1-1.5 bar of power. Also, Scorpion is immune to critical damage and takes 30-50% less damage from Netherrealm opponents.
Inferno Scorpion	Each time Inferno Scorpion tags-in, he gets +200% basic attack damage for 6 seconds.
Injustice Scorpion	+25% damage against enemies affected by fire.
Klassic Scorpion	Achieving 80%+ on the Spear (Special Attack 1), makes it unblockable and pulls the most wounded opponent from the enemy team into combat and causes Bleed.
Kold War Scorpion	Achieving 80%+ on Flame Shield (Special Attack 2) applies Fire DOT for 3-9 seconds to the entire enemy team. Kold War Scorpion is immune to fire. All Kold War Teammates that achieve 90-80%+ on Special Attack 2 apply Fire DOT on the enemy.
MK1 Scorpion	When MK1 Scorpion successfully hits his opponent, he gains 2% of Fire Vitality Energy. Successful Special and Fatal Blow Attacks gain more Fire Vitality Energy:Special Attack 1 - 10% of Energy.Special Attack 2 - 30% of Energy.Fatal Blow - 50% of Energy.When a Fire Vitality bar fills, MK1 Scorpion gains Shield for 7 seconds and increases his Attack based on the Fire Vitality meter:1 bar - 10% Attack Boost.2 bars - 15% Attack Boost.Full/3 bars - 25% Attack Boost.When MK1 Scorpion receives fatal damage, if the Fire Vitality meter is full (3 bars), he ignites to stay alive and the Fire Vitality meter starts to drain. Ignited MK1 Scorpion is immune to damage and all negative Kombat Effect. He cannot be tagged out, and his power generation is increased by 20%. If ignited and the Fire Vitality meter has completely drained, he explodes and deals heavy damage to the active opponent.
MK11 Scorpion	Apply fire to 1-3 opponent(s) for 5-9 seconds at the start of the match and when MK11 Scorpion tags-in. Fire DOTs add up together. MK11 teammates have 25% chance for Lethal Blow on basic attacks.
Ninjutsu Scorpion	+30% attack for Martial Artists.
Standard Scorpion	+15% attack for Martial Artists.
Strike Force Scorpion	When a teammate would be KO'd, Scorpion tags-in and counter-attacks with low/medium/heavy damage; saved teammates recover 5-15% of their health. Having 2 Strike Force teammates allows Scorpion to make an additional save. Strike Force teammates power drain on tag-in.
Sergeant	+5% health for Spec Ops teammates.
Klassic Shang Tsung	On Combo Enders Klassic Shang Tsung can randomly morph into one of the Klassic Characters and perform their Combo Ender instead. On Special Attack 2 Klassic Shang Tsung can choose a Klassic Character to morph into and perform their Special Attack 2: Klassic Liu Kang - 'Soul of the Dragon' applies Stun. Klassic Rain - 'Mind Control Orb' applies Soaked. Klassic Raiden - 'Power Discharge' applies Weaken. Klassic Jax Briggs - 'Backbreaker' applies Cripple. Klassic Ermac - 'Certain Death' applies Snare. Opponent's have a 75% chance to miss Shang Tsung with Basic and Special attacks for 3 seconds after any of his morphing moves. Shang Tsung's own Special Attack 2 'Corpse Drop' drains 50% of an opponent's current power.
MK1 Shang Tsung	MK1 Shang Tsung gathers opponent's Blood to craft powerful Elixirs and conduct his ominous experiments. Each combo ender has a chance to be an Injection that gathers the Blood and adds it to the Blood Pool. Shang Tsung collects the same amount of Blood on tag-in attack, and Special Attack 2 "Injection" fills the whole Pool. When the Pool is full, an Elixir of choice can be crafted. It can be injected into the opponent's body to apply a powerful effect that leaves debilitating post-effect till the end of the match: Yellow Elixir - drains all opponent's power in 1 sec. and leaves them with power generation reduced by 10%. Red Elixir - stuns opponent for 3 sec. and leaves them slowed down by 10%. Green Elixir - increases damage received by the opponent by 100% for 5 seconds and leaves them with 10% less chance to block an incoming attack. If an opponent is killed while any Elixir effect is active - he resurrects on Shang Tsung's side as Meat. It cannot use equipment or passive effects, but has a 35% Critical Hit and Unblockable attack chance boost. Shang Tsung is healed by 15-25% of damage done by the creature. Shang Tsung can be tagged-in while his teammates are under Basic Combo attacks, counterattacking with a tag-in attack.
MK11 Shang Tsung	On tag-in MK11 Shang Tsung morphs into one of his non-boss opponents for 10-20 seconds, allowing him to use their own Special Attacks and X-Ray/Fatal Blow. When below 2 Bars of Power, MK11 Shang Tsung passively generates Power over time.
Konqueror Shao Kahn	Once per match, Emperor's Bash (Special Attack 2) instantly defeats a non-boss opponent if under 20-40% health. Shao Kahn has a 35-45% chance of helping tagged-in Outworld teammates by throwing his hammer at the opponent.
Bone Shaper Shinnok	For each defeated fighter on any team, Shinnok's attack increases by 25%. On any enemy resurrect, Shinnok's attack increases by 25%.
Vengeful Shinnok	Shinnok can gain Shadow Armor by executing a Combo Ender. This halves damage from Special Attacks and causes bleed when special attacks are blocked. +20% critical hit chance for all Netherrealm Characters on the team
Shirai Ryu	+5% attack for Martial Artist teammates.
Edenian Blood Sindel	Edenian Blood Sindel applies a Resonance effect on her Combo Enders. It reduces her opponent's speed by 3% and stacks up to 3 times. If her opponent is affected by 3 Resonance effects, 5 times per match Sindel can use her Banshee Scream counter-attack, removing all Resonance effects, dealing damage, and plunging her foe into the Sonic Shock state for 5 seconds. Sonic Shocked characters cannot attack, block, or tag-out, and all basic Basic Combo Attacks against them gain Power Steal. Sonic Shock ends if they are damaged by a Special Attack. Special Attacks' damage is increased by 50% against opponents in Sonic Shock. For each additional Edenian Blood teammate, Sonic Shock duration is increased by 1 second.
MK11 Sindel	1-3 Times per match at the moment of her choice, MK11 Sindel can counter-attack enemy's Basic Attack with a move that applies Stun. On successful Combo Ender, Maleficent March (Special Attack 2) and Edenian Royal Decree (Fatal Blow), Sindel's scream applies Weaken to the opponent. MK11 Sindel has 50% chance to apply Shield Break for any Special Attack performed against her.
Assassin Skarlet	At the start of the match, Assassin Skarlet applies bleed to all opponents for 5-15 seconds. While Skarlet is active, she steals 1-1.66% of a bleeding opponent's power every second. Assassin characters have 10-30% Lethal Blow chance against opponents who have less than 50% health.
Klassic Skarlet	Each opponent of Klassic Skarlet starts the fight with 15 Blood Droplets. After fighting an enemy for 3 sec, she starts stealing the Droplets over time and causing Anemia when all are stolen. Fighting against an Anemic foe, Skarlet gradually steals their power and Retch-Rebution (Special Attack 2) starts healing her for 50% of the damage dealt. For each Blood Droplets stolen, Skarlet receives 1% less damage. When defeated, Klassic Skarlet deals damage to the active opponent based on the number of Droplets she has collected. Skarlet's Special Attack 1 and Fatal Blow apply stacking Gash effect that deals damage over time based on her attack stat.
Kold War Skarlet	Whenever reduced to below 30% health Kold War Skarlet gains Krimson Shield, which reflets back 50% of the enemy's initial damage from Basic Attack, Special Attack, and X-Ray/Fatal Blow damage. All Kold War teammates have a 40-60% chance to gain Krimson Shield for 7-12 seconds on Special Attack 1.
MK11 Skarlet	When MK11 Skarlet defeats an opponent, she makes blood rain for 20-40 seconds. While it is raining blood, MK11 Skarlet gets a 20-50% damage boost and MK11 teammates apply bleed on combo enders as well as gain light/moderate/heavy vampirism against bleeding opponents.
Klassic Smoke	Any opponent fighting against Klassic Smoke for 10 seconds gets affected by Blind. Each time Klassic Smoke or his Klassic teammate resists a debuff, this debuff is instead applied to the opponent.
MK1 Smoke	Every 10 seconds MK1 Smoke can throw a smoke bomb and activate Ninjutsu for 8-12 sec. During Ninjutsu, MK1 Smoke performs unique Combo Enders with a 150% damage boost for them. Ninjutsu activation and each unique Combo Ender grants Smoke a stack of Fuming buff. It increases his Basic Attacks unblockable chance by 10% and stacks up to 7 times. On the maximum stacks, Smoke gains +10-30% Critical Hit chance boost. Additionally, MK1 Smoke applies Bleed on tag-in.
Demolition Sonya Blade	+30% attack for Spec Ops teammates.
Klassic Sonya Blade	Sonya's Neutralized (special attack 1) deals damage to the entire enemy team and breaks their shields. Also, all Spec Ops on her team ignore enemy toughness.
Klassic Movie Sonya Blade	Along with all other attacks, Klassic Movie Sonya Blade can perform special Combo Sequences. These Combo Sequences spend 0.8-06 of Bar of Power and can be repeated after 8-6 seconds. Sequences can be Amplified by additional moves. "Beatdown Hit" - Sonya's fists can pierce any enemy! You can Amplify this attack with Shield Break. Tap → Swipe left → Swipe right → Swipe up. Amplify: Swipe right "High Counter Hit" - Break your enemy's bones! You can Amplify this attack with Cripple. Swipe down → Swipe left → Swipe right → Tap. Amplify: Swipe down "Leg Takedown Hit" - Shake your enemy's brains! You can Amplify this attack with Extra Damage. Swipe right → Swipe down → Swipe up. Amplify: Tap
Kold War Sonya Blade	Each Team member starts encased in Ice Armor that reduces 60-90% damage of a special attack or X-Ray/Fatal Blow for 8 seconds. Kold War Characters have no time limit on Ice Armor. All Kold War Teammates have a 40-60% chance to gain Ice Armor on special attack 2.
Kombat Cup Sonya Blade	All Kombat Cup characters on team are immune to stun. The first time Sonya tags-in, she forces the opponent to tag-out and lose all power. That forced-out opponent has recovery and power generation disabled and cannot tag-in. Bosses are immune.
Standard Sonya Blade	+15% attack for Spec Ops teammates.
Tactical Sonya Blade	Sonya Blade activates a Drone on her Special Attack 2, choosing between multiple attack modes: stunning explosion, unblockable blast, or double damage detonation.
Tormented Soul Spawn	During the fight, Spawn generates Necroplasm energy over time. Generation while tagged-out is 5% per second. Generation while tagged-in is based on the number of alive teammates: 2 teammates - 3% per second, 1 teammate - 4% per second, Spawn is the last (or the only) character - 5% per second. When Spawn accumulates one or more bars of Necroplasm, he can counterattack the enemy and spend the available bars of Necroplasm. The more Necroplasm bars are accumulated, the stronger the counterattack will be. While tagged-in, Spawn gains 10% Attack Boost for the first active Necroplasm bar and an additional 5% per each next one. 1 bar - low damage, 2 bars - medium damage + Stun, 3 bars - high damage + Stun + Cripple
CoS Sub-Zero	Circle of Shadow Sub-Zero gains +5-15% attack damage and power gain for every Circle of Shadow character on his team. Circle of Shadow Characters have +5-15% chance for lethal blows.
Cryomancer Sub-Zero	+30% health for Martial Artists.
Grandmaster Sub-Zero	Sub-Zero replaces himself with a decoy; evading a fatal blow.
Klassic Sub-Zero	Performing Slide Kick (Special Attack 2) at 80%+ activates a continuous chain of Special Attacks. Can be chained up to 6 times.
Kold War Sub-Zero	Increases team's power generation and decreases opponents power generation for each Kold War team member. Kold War Sub-Zero does +50% critical damage against enemies affected by frostbite. Kold War teammates using Special Attacks have a 30-50% chance to cause frostbite.
MK11 Sub-Zero	Any opponent fighting against MK11 Sub-Zero for 12-8 seconds gets frostbite. When performing combo enders against frostbitten opponents, MK11 Sub-Zero has a 15-35% chance of freezing them. Sub-Zero saves each MK11 teammate once, by replacing him or her with an Ice Clone. The Ice Clone explodes, dealing low/medium/heavy damage and causing bleed.
Onslaught Sub-Zero	When Onslaught Sub-Zero receives fatal damage, once per match he encases himself in Cryoshell. While Cryoshell is active, he becomes invincible and gains up to 50% of max. health and full power over time. The opponent must hit the Cryoshell 15 times to shatter it. For each Combo Ender against it, the opponent receives a stack of Coldgrip. Each Coldgrip increases Special Attack damage taken by the opponent by 10% and adds a 20% chance to Freeze them on a tag-out attempt. Coldgrip is also applied on any Special Attack, up to total of 5 stacks. Sub-Zero assists his teammates every 12 with an Ice Ball, which applies a stack of Coldgrip.
Standard Sub-Zero	+15% health for Martial Artist teammates.
Ronin Takeda	+30% attack for each Ronin teammate vs. Spec Ops. All Ronin Characters gain 10-30% critical damage for each Ronin Character on team.
Shirai Ryu Takeda	When Takeda successfully blocks any basic attack, there is a chance he counters. Kung Jin, Cassie Cage, and Jacqui Briggs gain +30% damage, health and critical hit damage when on the same team.
Kobu Jutsu Tanya	Thrice per match, Spinning Stab (special attack 2) deals 25% of its damage to the entire enemy team and breaks shields. In Faction Wars, 25% chance for Lethal Blow.
Pyromancer Tanya	Surging Blast (Special Attack 2) and a unique Combo Ender that has 30% chance to be performed, powder the opponent with Devil's Dust that sticks for 20 sec. Characters affected by Devil's Dust are Blinded and take 50% more damage from Fire Attacks and Fire DOTs. Martial Artist and Outworld teammates' Combo Enders become Fire Attacks and apply Fire DOT, stacking up to 2 times on opponents affected by Devil's Dust.
Treacherous Tanya	Tanya disables her opponent's Equipment card on any successful Special Attack. Power Drain has a reduced effect on her teammates.
Dark Fate Terminator	Terminator cancels all Krushing Blows, X-Ray Attacks and Fatal Blows performed against him. After being defeated Terminator turns into an Endoskeleton. When in Endoskeleton mode he regains all health, loses all power, does not generate power and cannot tag-out, but is immune to poison, bleed and fire, and takes 10-30% less damage. 
Guardian Terminator	Guardian Terminator has a 30-60% chance to save any active teammate from Special Attack. When triggered, Guardian Terminator automatically tags in and blocks the attack, receiving 50% less damage from the attack and all other blocked attacks for the next 7-15 seconds, and gains 1 bar of power. This effect triggers as long as Guardian Terminator is above 30% Health and tag-in is off cooldown. Guardian Terminator cancels all Krushing Blows, X-ray Attacks and Fatal Blows performed against him.
Ace of Knaves The Joker	Joker owns thee card decks with different unique abilities. Each time Joker enters the fight, he chooses one deck that he is going to use in this battle. By using cards from the active deck, Joker inflicts damage on the opponent and also applies this deck's corresponding unique effect. The amount of cards inside the deck is limited. Venom Deck - The card intoxicates the opponent with "Joker's Juice". The affected opponent has a 50% chance to miss their attacks and takes small damage over time. Grinning Deck - The explosive card deals medium damage, temporarily disables opponent's Special Attacks, and has a 50% chance to destroy opponent's armor or weapon. Buzzer Deck - The card attaches a tiny buzzer that will continue to strike the opponent with electricity until it is out of battery. It deals more and more damage along with draining power with every strike. To remove the buzzer, the opponent has to tag-out.
Aftershock Tremor	Each time Aftershock Tremor tags-in, the weakest enemy tags-in and is stunned. Martial Artists on the team have a chance of unblockable attacks against Netherrealm.
Black Dragon Tremor	After using a special attack, Black Dragon Tremor sheds his Gold Skin and gains Lava Skin. While in Gold Skin form, Black Dragon Tremor gains 30-70% resistance to all debuffs. While in Lava Skin form, Black Dragon Tremor's next special attack will have fire effect, and his special attack 2 will also deal 20-50% damage to tagged-out opponents. Black Dragon Tremor switches between skin forms each time he uses a special attack.
Cyrax (LK-4D4) Triborg	All Triborg characters on your team gain increased critical hit chance for special attack 1 and everyone on your team gains +50% critical damage.
Sektor (LK-9T9) Triborg	All Triborg characters on your team gain fire for special attack 1 and everyone on your team deals +30% more fire damage.
Smoke (LK-7T2) Triborg	All Triborg Characters on your team gain power drain for Special Attack 1 and everyone on your team steals 50% of any power they drain and distributes it to the team.
Sub-Zero (LK-520) Triborg	All Triborg characters gain a support robot to improve any special attack with frostbite. On tag-in he gains a 5-second ice shield. His teammates have +50% critical hit chance against enemies affected by freeze.
Trooper	+5% attack for Spec Ops teammates.